70 70 70 70 70 70 70 70 70 70 70 70 70 70 70 70 70 70 70 70 70 70 70 70 70 70 70 70 70 70 70 70 70 70 70 70 70 70 70 70 70 70 70 70 70 70 70 70 70 70 70 70 70 70 70 70 70 70 70 70 70 70 70 70 70 70 70 70 70 70 70 70 70 70 70 70 70 70 70 70 70 70 70 70 70 70 70 70 70 70 70 70 70 70 70 70 70 70 70 70
70 70 70 70 70 70 70 70 70 70 70 70 70 70 70 70 70 70 70 70 70 70 70 70 70 70 70 70 70 70 70 70 70 70 70 70 70 70 70 70 70 70 70 70 70 70 70 70 70 70 70 70 70 70 70 70 70 70 70 70 70 70 70 70 70 70 70 70 70 70 70 70 70 70 70 70 70 70 70 70 70 70 70 70 70 70 70 70 70 70 70 70 70 70 70 70 70 70 70 70
70 70 70 70 70 70 70 70 70 70 70 70 70 70 70 70 70 70 70 70 70 70 70 70 70 70 70 70 70 70 70 70 70 70 70 70 70 70 70 70 70 70 70 70 70 70 70 70 70 70 70 70 70 70 70 70 70 70 70 70 70 70 70 70 70 70 70 70 70 70 70 70 70 70 70 70 70 70 70 70 70 70 70 70 70 70 70 70 70 70 70 70 70 70 70 70 70 70 70 70
70 70 70 70 70 70 70 70 70 70 70 70 70 70 70 70 70 70 70 70 70 70 70 70 70 70 70 70 70 70 70 70 70 70 70 70 70 70 70 70 70 70 70 70 70 70 70 70 70 70 70 70 70 70 70 70 70 70 70 70 70 70 70 70 70 70 70 70 70 70 70 70 70 70 70 70 70 70 70 70 70 70 70 70 70 70 70 70 70 70 70 70 70 70 70 70 70 70 70 70
70 70 70 70 70 70 70 70 70 70 70 70 70 70 70 70 70 70 70 70 70 70 70 70 70 70 70 70 70 70 70 70 70 70 70 70 70 70 70 70 70 70 70 70 70 70 70 70 70 70 70 70 70 70 70 70 70 70 70 70 70 70 70 70 70 70 70 70 70 70 70 70 70 70 70 70 70 70 70 70 70 70 70 70 70 70 70 70 70 70 70 70 70 70 70 70 70 70 70 70
70 70 70 70 70 70 70 70 70 70 70 70 70 70 70 70 70 70 70 70 70 70 70 70 70 70 70 70 70 70 70 70 70 70 37 37 70 70 70 70 70 70 70 70 70 70 70 70 70 70 70 70 70 70 70 70 70 70 70 70 70 70 70 70 70 70 70 70 70 70 70 70 70 70 70 70 70 70 70 70 70 70 70 70 70 70 70 70 70 70 70 70 70 70 70 70 70 70 70 70
70 70 70 70 70 70 70 70 70 70 70 70 70 70 70 70 70 70 70 70 70 70 70 70 70 70 70 70 70 70 37 37 37 37 37 37 37 37 70 70 70 70 70 70 37 37 70 70 70 70 70 70 70 70 70 70 70 70 70 70 70 70 70 70 70 70 70 70 70 70 70 70 70 70 70 70 70 70 70 70 70 70 70 70 70 70 70 70 70 70 70 70 70 70 70 70 70 70 70 70
70 70 70 70 70 70 70 70 70 70 70 70 70 70 70 70 70 70 70 70 70 70 70 70 70 70 70 70 70 10 37 37 37 37 10 10 37 37 37 37 37 37 37 70 37 37 37 37 70 70 70 70 70 70 70 70 70 70 70 70 70 70 70 70 70 70 70 70 70 70 70 70 70 70 70 70 70 70 70 70 70 70 70 70 70 70 70 70 70 70 70 70 70 70 70 70 70 70 70 70
70 70 70 70 70 70 70 70 70 70 70 70 70 70 70 70 70 70 70 70 70 70 70 70 70 70 70 70 70 10 10 10 10 10 10 10 10 37 37 37 37 37 37 37 37 37 37 37 37 70 70 37 37 70 70 70 70 70 70 70 70 70 70 70 70 70 70 70 70 70 70 70 70 70 70 70 70 70 70 70 70 70 70 70 70 70 70 70 70 70 70 70 70 70 70 70 70 70 70 70
70 70 70 70 70 70 70 70 70 70 70 70 70 70 70 70 70 70 70 70 70 70 70 70 70 70 70 70 70 10 10 10 10 10 10 10 10 10 10 37 37 10 37 37 37 37 10 37 37 37 37 37 37 70 70 70 70 37 37 37 37 70 70 70 70 70 70 70 70 70 70 70 70 70 70 70 70 70 70 70 70 70 70 70 70 70 70 70 70 70 70 70 70 70 70 70 70 70 70 70
70 70 70 70 70 70 70 70 70 70 70 70 70 70 70 70 70 70 70 70 70 10 10 10 10 10 10 10 10 10 10 10 10 10 10 10 10 10 10 10 10 10 10 10 10 10 10 10 37 37 37 37 70 70 70 70 37 37 37 37 37 37 37 70 70 70 70 70 70 70 70 70 70 70 70 70 70 70 70 70 70 70 70 70 70 70 70 70 70 70 70 70 70 70 70 70 70 70 70 70
70 70 70 70 70 70 70 70 70 70 70 70 70 70 70 70 70 70 70 70 70 10 10 10 10 10 10 10 10 10 10 10 10 10 10 10 10 10 10 10 10 10 10 10 10 10 10 10 10 10 37 37 37 70 70 37 37 37 10 10 10 37 37 37 37 37 37 37 37 37 70 70 70 70 70 70 70 70 70 70 10 10 70 70 70 70 70 70 70 70 70 70 10 10 10 70 70 70 70 70
70 70 70 70 70 70 70 70 70 70 70 70 70 70 70 70 70 70 10 10 10 10 10 10 10 10 10 10 10 10 10 10 10 10 10 10 10 10 10 10 10 10 10 10 10 10 10 10 10 10 10 37 37 37 37 37 37 10 10 10 10 10 37 37 37 37 37 37 37 37 37 37 70 70 70 70 70 70 10 10 10 10 10 10 70 70 70 70 70 70 10 10 10 10 10 70 70 70 70 70
70 70 70 70 70 70 70 70 70 70 70 70 70 70 70 70 70 70 10 10 10 10 10 10 10 10 10 10 10 10 10 10 10 10 10 10 10 10 10 10 10 10 10 10 10 10 10 10 10 10 10 10 10 10 10 10 10 10 10 10 10 10 10 37 37 37 37 37 37 37 37 37 37 37 37 70 10 10 10 10 10 10 10 10 70 70 70 70 70 10 10 10 10 10 10 10 10 70 70 70
70 70 70 70 70 70 70 70 70 70 70 70 70 70 70 70 70 10 10 10 10 10 10 10 10 10 10 10 10 10 10 10 10 10 10 10 10 10 10 10 10 10 10 10 10 10 10 10 10 10 10 10 10 10 10 10 10 10 10 10 10 10 10 10 10 10 10 10 10 10 10 10 10 10 10 10 10 10 10 10 10 10 10 10 62 62 62 62 62 10 10 10 10 10 10 10 10 70 70 70
70 70 70 70 70 70 70 70 70 70 70 70 70 70 70 70 10 10 10 10 10 10 10 10 10 10 10 10 10 10 10 10 10 10 10 10 10 10 10 10 10 10 10 10 10 10 10 10 10 10 10 10 10 10 10 10 10 10 10 10 10 10 10 10 10 10 10 10 10 10 10 10 10 10 10 10 10 10 10 10 10 10 10 10 70 70 70 70 70 10 10 10 10 10 10 10 10 70 70 70
70 70 70 70 70 70 70 70 70 70 70 70 70 70 70 70 10 10 10 10 10 10 10 10 10 10 10 10 10 10 10 10 10 10 10 10 10 10 10 10 10 10 10 10 10 10 10 10 10 10 10 10 10 10 10 10 10 10 10 10 10 10 10 10 10 10 10 10 10 10 10 10 10 10 10 10 10 10 10 10 70 70 70 70 70 70 70 70 70 10 10 10 10 10 10 10 10 70 70 70
70 70 70 70 70 70 70 70 70 70 70 70 70 70 70 70 10 10 10 10 10 10 10 10 10 10 10 10 10 10 10 10 10 10 10 10 10 10 10 10 10 10 10 10 10 10 10 10 10 10 10 10 10 10 10 10 10 10 10 10 10 10 10 10 10 10 10 10 10 10 10 10 10 10 10 10 10 10 10 70 70 70 70 70 70 70 70 70 10 10 10 10 10 10 10 10 10 70 70 70
70 70 70 70 70 70 70 70 70 70 70 70 70 70 70 70 10 10 10 10 10 10 10 10 10 10 10 10 10 10 10 10 10 10 10 10 10 10 10 10 10 10 10 10 10 10 10 10 10 10 10 10 10 10 10 10 10 10 10 10 10 10 10 10 10 10 10 10 10 10 10 10 10 10 10 10 10 10 10 70 70 70 70 70 70 70 70 70 10 10 10 10 10 10 10 10 10 70 70 70
70 70 70 70 70 70 70 70 70 70 70 70 70 70 70 70 10 10 10 10 10 10 10 10 10 10 10 10 10 10 10 10 10 10 10 10 10 10 10 10 10 10 10 10 10 10 10 10 10 10 10 10 10 10 10 10 10 10 10 10 10 10 10 10 10 10 10 10 10 10 10 10 10 10 37 37 37 37 70 70 70 70 70 70 70 70 70 70 70 10 10 10 10 10 10 10 10 70 70 70
70 70 70 70 70 70 70 70 70 70 70 70 70 70 70 70 70 70 70 70 10 10 10 10 70 70 70 10 10 10 10 10 10 10 10 10 10 10 10 10 10 10 10 10 10 10 10 10 10 10 10 10 10 10 10 10 10 10 10 10 10 37 37 37 10 10 10 10 10 10 10 10 10 37 37 37 37 70 70 70 70 70 70 70 70 70 70 70 70 10 10 10 10 10 10 10 10 70 70 70
70 70 70 70 70 70 70 70 70 70 70 70 70 70 70 70 70 70 70 70 70 70 70 70 70 70 70 10 10 10 10 10 10 10 10 10 10 10 10 10 10 10 10 10 10 10 10 10 10 10 10 10 10 10 10 10 10 10 10 10 37 37 37 37 10 10 10 37 37 37 37 37 37 37 37 37 37 70 70 70 70 70 70 70 70 70 70 70 70 70 10 10 10 10 10 10 10 70 70 70
70 70 70 70 70 70 70 70 70 70 70 70 70 70 70 70 70 70 70 70 70 70 10 10 10 10 10 10 10 10 10 10 10 10 10 10 10 10 10 10 10 10 10 10 10 10 10 10 10 10 10 10 10 10 10 10 10 10 10 37 37 70 70 37 37 37 37 37 37 37 37 37 37 37 37 70 70 70 70 70 70 70 70 70 70 70 70 70 70 70 70 70 70 10 10 10 70 70 70 70
70 70 70 70 70 70 70 70 70 70 70 70 70 70 70 70 70 70 70 70 70 10 10 10 10 10 10 10 10 10 10 10 10 10 10 10 10 10 10 10 10 10 10 10 10 10 10 10 10 10 10 10 10 10 10 10 10 10 10 10 10 10 10 70 37 37 37 37 37 37 37 37 37 37 70 70 70 70 70 71 70 70 70 70 70 70 70 70 70 70 70 70 70 10 10 10 70 70 70 70
70 70 70 70 70 70 70 70 70 70 70 70 70 70 70 70 70 70 70 70 70 70 70 70 70 70 10 10 10 10 10 10 10 10 10 10 10 10 10 10 10 10 10 10 10 10 10 10 10 10 10 10 10 10 10 10 10 10 10 10 10 10 10 70 70 70 70 37 37 37 37 37 37 37 70 70 70 70 71 70 70 70 70 70 70 70 70 70 70 70 70 70 70 10 10 10 70 70 70 70
70 70 70 70 70 70 70 70 70 70 70 70 70 70 70 70 70 70 70 70 70 70 70 70 70 70 10 10 10 10 10 10 10 10 10 10 10 10 10 10 10 10 10 10 10 10 10 10 10 10 10 10 10 10 10 10 10 10 10 10 10 10 10 70 70 70 70 70 70 70 70 70 70 70 70 70 71 70 70 70 70 70 70 70 70 70 70 70 70 70 70 70 70 70 70 70 70 70 70 70
70 70 70 70 70 70 70 70 70 70 70 70 70 70 70 70 70 70 70 70 70 70 70 71 10 10 10 10 10 10 10 10 10 10 10 10 10 10 10 10 10 10 10 10 10 10 10 10 10 10 10 10 10 10 10 10 10 10 10 10 10 10 10 10 70 70 70 70 70 70 70 70 70 70 70 70 70 70 70 70 70 70 70 70 70 70 70 70 70 70 70 70 70 70 70 70 70 70 70 70
70 70 70 70 70 70 70 70 70 70 70 70 70 37 37 37 37 37 37 70 70 70 70 70 10 10 10 10 10 10 10 10 10 10 10 10 10 10 10 10 10 10 10 10 10 10 10 10 10 10 10 10 10 10 10 10 10 10 10 10 10 10 10 10 70 70 70 70 70 70 70 70 70 70 70 70 70 70 70 70 70 70 70 70 70 70 70 70 70 70 70 70 70 70 70 70 70 70 70 70
70 70 70 70 70 70 70 70 70 70 37 37 37 37 37 37 37 37 37 37 70 70 70 70 70 70 10 10 10 10 10 10 10 10 10 10 10 10 10 10 10 10 10 10 10 10 10 10 10 10 10 10 10 10 10 10 10 10 10 10 10 10 10 10 10 70 70 70 70 71 70 70 70 70 70 70 71 70 70 70 70 70 70 70 70 70 70 70 70 70 70 70 70 70 70 70 70 70 70 70
70 70 70 70 70 70 70 70 37 37 37 37 10 10 10 10 10 10 10 37 37 37 70 70 70 70 10 10 10 10 10 10 10 10 10 10 10 10 10 10 10 10 10 10 10 10 10 10 10 10 10 10 10 10 10 10 10 10 10 10 10 10 10 10 10 10 70 70 70 70 70 70 71 70 70 70 70 70 70 70 70 70 70 70 70 70 70 70 70 70 70 70 70 70 70 70 70 70 70 70
70 70 70 70 70 70 70 70 37 37 10 10 10 10 10 10 10 10 10 10 10 10 10 10 10 10 10 10 10 10 10 10 10 10 10 10 10 10 10 10 10 10 10 10 10 10 10 10 10 10 10 10 10 10 10 10 10 10 10 10 10 10 10 10 10 10 70 70 70 70 70 70 70 70 70 70 70 70 70 70 70 70 70 70 70 70 70 70 70 70 70 70 70 70 70 70 70 70 70 70
70 70 70 70 70 70 70 37 37 37 10 10 10 10 10 10 10 10 10 10 10 10 10 10 10 10 10 10 10 10 10 10 10 10 10 10 10 10 10 10 10 10 10 10 10 10 10 10 10 10 10 10 10 10 10 10 10 10 10 10 10 10 10 10 10 10 10 70 70 70 70 70 71 70 70 70 70 70 70 70 70 70 70 70 70 70 70 70 70 70 70 70 70 70 70 70 70 70 70 70
70 70 70 70 70 70 70 37 37 37 10 10 10 10 10 10 10 10 10 10 10 10 10 10 10 10 10 10 10 10 10 10 10 10 10 10 10 10 10 10 10 12 12 12 12 12 12 10 10 10 10 10 10 10 10 10 10 10 10 10 10 10 10 10 10 10 10 70 70 70 70 70 70 70 70 70 70 71 70 70 70 70 70 70 70 70 70 70 70 70 70 70 70 70 70 70 70 70 70 70
70 70 70 70 70 70 70 37 37 37 37 10 10 10 10 10 10 10 10 10 10 10 10 10 10 10 10 10 10 10 10 10 10 10 10 10 10 10 10 10 14 70 70 70 70 70 70 12 12 12 10 10 10 10 10 10 10 10 10 10 10 10 10 10 10 10 10 10 10 70 70 70 70 70 70 70 70 70 70 70 70 70 70 70 70 70 70 70 70 70 70 70 70 70 70 70 70 70 70 70
70 70 70 70 70 70 70 70 37 37 37 10 10 10 10 10 10 10 10 10 10 10 10 10 10 10 10 10 10 10 10 17 12 12 12 12 12 12 12 12 22 70 70 70 70 70 70 70 70 70 10 10 10 10 10 10 10 10 10 10 10 10 10 10 10 10 10 10 10 70 70 70 70 70 70 70 70 70 70 70 70 70 70 70 70 70 70 70 70 70 70 70 70 70 70 70 70 70 70 70
70 70 70 70 70 70 70 70 37 37 37 10 10 10 10 10 10 10 10 10 10 10 10 34 33 10 10 10 10 10 10 14 70 70 70 70 70 70 70 70 70 70 70 70 70 70 70 70 70 70 10 10 10 10 10 10 10 10 10 10 10 10 10 10 10 10 10 10 10 10 10 70 70 70 70 70 10 10 10 10 70 70 70 70 70 70 70 70 70 70 70 70 70 70 70 70 70 70 70 70
70 70 70 70 70 70 70 70 37 37 10 10 10 10 10 10 10 10 10 10 10 10 10 28 27 10 10 10 10 10 10 14 70 70 70 70 71 70 70 70 70 70 70 70 70 71 71 70 70 70 70 10 10 10 10 10 10 10 10 10 10 10 10 10 10 10 10 10 10 10 10 70 70 70 70 70 10 10 10 10 70 70 70 70 70 70 70 70 70 70 70 70 70 70 70 70 70 70 70 70
70 70 70 70 70 70 70 37 37 37 10 10 10 10 10 10 10 10 10 10 10 10 10 28 27 10 10 10 10 10 10 14 70 70 71 71 70 70 70 70 70 70 70 70 70 70 70 70 70 70 70 12 12 12 70 10 10 10 10 10 10 10 10 10 10 10 10 10 10 10 10 70 70 71 70 70 10 10 10 10 10 10 10 10 70 70 70 70 70 70 70 70 70 70 70 70 70 70 70 70
70 70 70 70 70 70 70 37 37 37 10 10 10 10 10 10 10 10 10 10 10 10 10 28 27 10 10 10 10 10 10 14 70 70 70 70 70 70 70 71 70 70 70 70 70 70 70 70 70 70 70 70 70 70 70 10 10 10 10 10 10 10 10 10 10 10 10 10 70 70 70 70 70 70 70 70 70 70 10 10 10 10 10 10 70 70 70 70 70 70 70 70 70 70 70 70 70 70 70 70
70 70 70 70 70 70 70 37 37 10 10 10 10 37 37 37 37 10 10 10 10 10 10 28 27 10 10 10 10 10 10 19 20 70 70 70 70 70 70 70 70 70 70 70 70 70 70 71 71 70 70 70 70 70 70 70 70 10 10 10 10 10 10 10 10 10 10 70 70 70 70 70 70 70 70 70 70 70 10 10 10 10 10 10 10 70 70 70 70 70 70 70 70 70 70 70 70 70 70 70
70 70 70 70 70 70 70 70 37 37 37 37 37 37 37 37 37 37 37 10 10 10 10 28 27 10 10 10 10 10 10 10 14 70 70 70 70 70 70 70 70 70 70 70 70 70 70 70 70 70 70 70 70 70 70 70 70 10 10 10 10 70 10 10 10 10 10 70 70 70 70 70 70 71 70 70 70 70 10 10 10 10 10 10 10 70 70 70 70 70 70 70 70 70 70 70 70 70 70 70
70 70 70 70 70 70 70 70 70 70 70 37 37 37 37 37 37 37 37 10 10 10 10 28 27 10 10 10 10 10 10 10 19 13 13 13 20 70 70 70 70 70 70 70 70 70 70 70 70 70 70 70 70 70 70 70 70 70 70 10 10 70 70 70 70 10 10 70 71 71 70 70 71 70 70 70 70 70 10 10 10 10 10 10 10 70 70 70 70 70 70 70 70 70 70 70 70 70 70 70
70 70 70 70 70 70 70 70 70 70 70 70 70 70 70 70 70 70 70 10 10 10 10 28 27 10 10 10 10 10 10 10 10 10 10 10 19 13 13 13 13 20 70 70 70 70 70 70 70 71 70 70 70 70 70 70 70 70 70 70 70 70 70 70 70 70 71 70 71 70 70 70 70 70 70 71 70 70 10 10 10 10 10 10 70 70 70 70 70 70 70 70 70 70 70 70 70 70 70 70
70 70 70 70 70 70 70 70 70 70 70 70 70 70 70 70 70 70 70 10 10 10 10 28 27 10 10 10 10 10 10 10 10 10 10 10 10 10 10 10 10 14 70 70 70 70 70 70 70 70 70 70 70 70 70 70 70 70 70 70 70 70 71 70 70 70 70 70 70 70 70 10 10 70 70 70 70 70 70 10 10 70 70 70 70 70 70 70 70 70 70 70 70 70 70 70 70 70 70 70
70 70 70 70 70 70 37 37 37 37 37 37 37 37 37 70 70 70 70 10 10 10 10 28 27 10 10 10 10 10 10 10 10 10 10 10 10 10 10 10 10 14 70 70 70 70 70 70 70 70 70 70 70 70 70 70 70 70 70 70 70 70 71 70 70 70 70 70 70 70 70 10 10 10 10 10 10 10 10 10 10 10 70 70 70 70 70 70 70 70 70 70 70 70 70 70 70 70 70 70
70 70 70 70 37 37 37 37 37 37 37 37 37 37 37 37 37 37 37 10 10 10 10 28 27 10 10 10 10 10 10 10 10 10 10 10 10 10 10 10 10 19 20 70 70 70 70 70 70 70 70 70 70 70 70 70 70 70 70 70 70 70 70 70 70 70 70 70 70 70 70 10 10 10 10 10 10 10 10 10 10 10 70 70 70 70 70 70 70 70 70 70 70 70 70 70 70 70 70 70
70 70 70 70 37 37 37 37 10 10 10 10 37 37 37 37 37 37 10 10 10 10 10 28 27 10 10 10 10 10 10 10 10 10 10 10 10 10 10 10 10 10 19 13 13 13 13 20 70 70 70 70 70 70 70 70 70 70 70 70 70 70 70 70 70 70 70 70 70 10 10 10 10 10 10 10 10 10 10 10 10 10 70 70 70 70 70 70 70 70 70 70 70 70 70 70 70 70 70 70
70 70 70 70 37 37 37 37 10 10 10 10 10 10 10 10 10 10 10 10 10 10 10 28 24 26 26 26 26 26 33 10 10 10 10 10 10 10 10 10 10 10 10 10 10 10 10 14 70 70 70 70 70 70 70 70 70 70 70 71 70 70 70 70 71 70 70 70 70 10 10 10 10 10 10 10 10 10 10 10 10 10 70 70 70 10 10 70 70 70 70 70 70 70 70 70 70 70 70 70
70 70 70 70 37 37 37 10 10 10 10 10 10 10 10 10 10 10 10 10 10 10 10 36 25 25 25 25 25 29 24 10 10 10 10 10 10 10 10 10 10 10 10 10 10 10 10 19 13 13 13 20 70 70 70 70 70 70 70 70 70 70 70 70 70 70 70 70 70 70 70 10 10 10 10 10 10 10 10 10 10 10 70 70 70 10 10 10 10 10 10 70 70 70 70 70 70 70 70 70
70 70 70 70 37 37 37 10 10 10 10 10 10 10 10 10 10 10 10 10 10 10 10 10 10 10 10 10 10 28 32 26 26 26 26 26 26 26 26 26 26 26 26 26 26 26 33 10 10 10 10 19 13 62 62 62 62 62 62 62 62 62 62 62 62 62 62 62 62 70 70 10 10 10 10 10 10 10 10 10 10 10 10 10 10 10 10 10 10 10 10 70 70 70 70 70 70 70 70 70
70 70 70 70 37 37 37 10 10 10 10 10 10 10 10 10 10 10 10 10 10 10 10 10 10 10 10 10 10 28 30 25 25 25 25 25 25 25 25 25 25 25 25 25 25 25 35 10 10 10 10 10 10 67 67 67 67 67 67 67 67 67 67 67 67 67 67 67 67 10 10 10 10 10 10 10 10 10 10 10 10 10 10 10 10 10 10 10 10 10 10 70 70 70 70 70 70 70 70 70
70 70 70 70 37 37 37 10 10 10 10 10 10 10 10 10 10 10 10 10 10 10 10 10 10 10 10 10 10 28 27 10 10 10 10 10 10 10 10 10 10 10 10 10 10 10 10 10 10 10 10 10 12 63 63 63 63 63 63 63 63 63 63 63 63 63 63 63 63 10 10 10 10 10 10 10 10 10 10 10 10 10 10 70 70 10 10 10 10 10 10 70 70 70 70 70 70 70 70 70
70 70 70 70 70 37 37 10 10 10 10 10 10 10 10 10 10 10 10 10 10 10 10 10 10 10 10 10 10 28 27 10 10 10 10 10 10 10 10 10 10 10 10 10 10 10 10 10 10 10 10 14 70 70 70 70 70 70 70 70 70 71 70 70 70 71 71 70 70 10 10 10 10 10 10 10 10 10 10 10 10 10 10 70 70 10 10 10 10 10 10 70 70 70 70 70 70 70 70 70
70 70 70 70 70 37 37 10 10 10 10 10 10 10 10 10 10 10 10 10 10 10 10 10 10 10 10 10 10 28 27 10 10 10 10 10 10 10 10 10 10 10 10 10 10 10 10 10 10 10 10 14 70 70 70 70 70 71 71 70 70 70 70 70 70 70 70 70 70 70 70 10 10 10 10 10 10 10 10 10 10 10 10 70 70 10 10 10 10 10 10 70 70 70 70 70 70 70 70 70
70 70 70 70 70 37 37 10 10 10 10 10 10 10 10 10 10 10 10 10 10 10 10 10 10 10 10 10 10 28 27 10 10 10 10 10 10 10 10 10 10 10 10 10 10 10 10 10 10 10 10 37 39 39 39 46 70 70 70 71 70 70 70 70 70 70 70 70 70 70 70 70 70 70 70 10 10 10 10 10 10 10 10 70 70 70 70 70 70 10 10 70 70 70 70 70 70 70 70 70
70 70 70 70 37 37 37 10 10 10 10 10 10 10 10 10 10 10 10 10 10 10 10 10 10 10 10 10 10 28 27 10 10 10 10 10 10 10 10 10 10 10 10 10 10 10 10 10 10 10 10 10 37 37 37 40 70 70 70 70 70 71 70 70 70 70 70 70 70 70 70 70 70 70 70 10 10 10 10 10 10 10 10 70 70 70 70 70 70 70 70 70 70 70 70 70 70 70 70 70
70 70 70 70 37 37 37 10 10 10 10 10 10 10 10 10 10 10 10 10 10 10 10 10 10 10 10 10 10 28 27 10 10 10 10 10 10 10 10 10 10 10 10 10 10 10 10 10 10 10 10 10 10 37 37 37 39 46 70 70 70 70 70 70 70 70 71 70 70 70 70 70 70 71 70 70 70 10 10 10 10 10 10 10 70 70 70 70 70 70 70 70 70 70 70 70 70 70 70 70
70 70 70 70 37 37 37 10 10 10 10 10 10 10 10 10 10 10 10 10 10 10 10 10 10 10 10 10 10 28 27 10 10 10 10 10 10 10 10 10 10 10 10 10 10 10 10 10 10 10 10 10 10 37 37 37 37 37 39 39 46 70 70 70 71 70 70 70 70 70 70 70 70 70 70 70 70 70 70 70 70 70 10 10 70 70 70 70 70 70 70 70 70 70 70 70 70 70 70 70
70 70 70 70 37 37 37 37 37 10 10 10 10 10 10 10 10 10 10 10 10 10 10 10 10 10 10 10 10 28 24 26 26 26 26 26 24 27 10 10 10 10 10 10 10 10 10 10 10 10 10 10 10 10 10 37 37 37 37 43 48 70 70 70 70 70 70 70 70 70 70 70 70 70 70 70 70 70 70 70 70 70 10 10 70 70 70 70 70 70 70 70 70 70 70 70 70 70 70 70
70 70 70 70 37 37 37 37 37 37 37 37 37 37 10 10 10 10 10 10 10 10 10 10 10 10 10 10 10 28 30 25 25 25 25 25 29 27 10 10 10 10 10 10 10 10 10 10 10 10 10 10 10 10 10 10 37 37 37 40 70 70 70 70 70 70 70 70 70 70 71 71 70 70 71 70 70 70 70 70 70 70 70 70 70 70 70 70 70 70 70 70 70 70 70 70 70 70 70 70
70 70 70 70 70 70 37 37 37 37 37 37 37 37 37 37 10 10 10 10 10 10 10 10 10 10 10 10 10 28 27 10 10 10 10 10 28 27 10 10 10 10 10 10 10 10 10 10 10 10 10 10 10 37 37 37 37 43 38 48 70 70 70 70 70 70 70 70 70 70 70 70 70 70 70 70 70 70 70 70 70 70 70 70 70 70 70 70 70 70 70 70 70 70 70 70 70 70 70 70
70 70 70 70 70 70 37 37 37 37 37 37 37 37 37 37 37 37 37 10 10 10 10 10 10 10 10 10 10 28 27 10 10 10 10 10 28 27 10 10 10 10 10 10 10 10 10 10 10 10 10 10 37 37 37 37 37 40 70 70 70 70 70 70 70 70 70 70 70 70 70 70 70 70 70 70 70 70 70 70 70 70 70 70 70 70 70 70 70 70 70 70 70 70 70 70 70 70 70 70
70 70 70 70 70 70 70 70 70 70 37 37 37 37 70 37 37 37 37 10 10 10 10 10 10 10 10 10 10 28 27 10 10 10 10 10 28 27 10 10 10 10 10 10 10 10 10 10 37 37 37 37 37 37 37 37 37 40 70 70 70 70 70 70 70 70 70 70 70 70 70 70 70 70 70 70 70 70 70 70 70 70 70 70 70 70 70 70 70 70 70 70 70 70 70 70 70 70 70 70
70 70 70 70 70 70 70 70 70 70 70 70 70 70 70 37 37 37 37 10 10 10 10 10 10 10 10 10 10 28 27 10 10 10 10 10 28 27 10 10 10 10 10 10 10 10 10 37 37 37 37 37 37 37 37 37 37 40 70 70 70 70 70 70 70 70 70 70 70 70 70 70 70 70 70 70 70 70 70 70 70 70 70 70 70 70 70 70 70 70 70 70 70 70 70 70 70 70 70 70
70 70 70 70 70 70 70 70 70 70 70 70 70 70 70 70 70 37 37 10 10 10 10 10 10 10 10 10 10 28 27 10 10 10 10 10 28 27 10 10 10 10 10 10 10 10 10 37 37 37 37 37 37 43 38 38 38 48 70 70 70 70 70 70 70 70 70 70 70 70 70 70 70 70 70 70 70 70 70 70 70 70 70 70 70 70 70 70 70 70 70 70 70 70 70 70 70 70 70 70
70 70 70 70 70 70 70 70 70 70 70 70 70 70 70 70 70 37 37 10 10 10 10 10 10 10 10 10 10 36 35 10 10 10 10 10 28 27 10 10 10 10 10 10 10 10 10 37 37 37 37 37 37 40 70 70 70 70 70 70 70 70 70 70 70 70 70 70 70 70 37 37 37 37 70 70 70 70 70 70 70 70 70 70 70 70 70 70 70 70 70 70 70 70 70 70 70 70 70 70
70 70 70 70 70 70 70 70 70 70 70 70 70 70 70 70 70 37 37 10 10 10 10 10 10 10 10 10 10 10 10 10 10 10 10 10 28 27 10 10 10 10 10 10 10 37 37 37 37 37 37 37 37 37 40 70 70 70 70 70 70 70 70 70 70 70 70 70 37 37 37 37 37 37 37 37 70 70 70 70 70 70 37 37 37 37 70 70 70 70 70 70 70 70 70 70 70 70 70 70
70 70 70 70 70 70 70 70 70 70 70 70 70 70 70 70 70 37 37 10 10 10 10 10 10 10 10 10 10 10 10 10 10 10 10 10 28 27 10 10 10 10 10 10 10 37 37 37 37 37 37 43 38 38 48 70 70 70 70 70 70 70 70 70 70 37 37 37 37 37 37 37 37 37 37 37 37 37 37 37 37 37 37 37 37 37 37 37 37 37 70 70 70 70 70 70 70 70 70 70
70 70 70 70 70 70 70 70 70 70 70 70 70 70 70 70 70 37 37 10 10 10 10 10 10 10 10 10 10 10 10 10 10 10 10 10 28 27 10 10 10 10 10 10 37 37 37 37 37 37 37 40 70 70 70 70 70 70 70 70 70 70 70 70 70 37 37 37 37 37 37 37 10 10 10 37 37 37 37 37 37 37 10 10 37 37 37 37 37 37 70 70 70 70 70 70 70 70 70 70
70 70 70 70 70 70 70 70 70 70 70 70 70 70 70 70 70 70 37 37 37 37 37 37 10 10 10 10 37 37 37 10 10 37 10 10 28 27 10 10 10 70 70 37 37 37 43 38 38 38 48 70 70 70 70 70 70 70 70 70 70 70 70 70 70 37 37 37 37 37 37 37 10 10 10 10 10 10 10 10 10 10 10 10 37 37 37 37 37 37 37 37 37 70 70 70 70 70 70 70
70 70 70 70 70 70 70 70 70 70 70 70 70 70 70 70 70 70 37 37 37 37 37 37 10 10 10 10 37 37 37 37 37 37 37 10 28 27 10 10 10 70 70 38 38 38 48 70 70 70 70 70 70 70 70 70 70 70 70 70 70 70 70 37 37 37 37 37 37 37 10 10 10 10 10 10 10 10 10 10 10 10 10 10 10 10 10 37 37 37 37 37 37 70 70 70 70 70 70 70
70 70 70 70 70 70 70 70 70 70 70 70 70 70 70 70 70 70 70 70 70 37 37 37 37 37 37 37 37 37 37 37 37 70 70 10 28 27 10 10 10 70 70 70 70 70 70 70 70 70 70 70 70 70 70 70 70 70 70 70 70 70 70 37 37 37 37 37 37 37 10 10 10 10 10 10 10 10 10 10 10 10 10 10 10 10 10 10 10 10 37 37 37 37 70 70 70 70 70 70
70 70 70 70 70 70 70 70 70 70 70 70 70 70 70 70 70 70 70 70 70 70 70 37 37 37 37 37 37 37 70 70 70 70 70 10 28 27 10 70 70 70 70 70 70 70 70 70 70 70 70 70 70 70 70 70 70 70 70 70 70 70 70 37 37 37 37 37 37 37 10 10 10 10 10 10 10 10 10 10 10 10 10 10 10 10 10 10 10 10 10 37 37 37 70 70 70 70 70 70
70 70 70 70 70 70 70 70 70 70 70 70 70 70 70 70 70 70 70 70 70 70 70 70 70 70 70 70 70 37 70 70 70 70 70 64 66 66 65 70 70 70 70 70 70 70 70 70 70 70 70 70 70 70 70 70 70 70 70 70 70 70 70 70 37 37 37 37 10 10 10 10 10 10 10 10 10 10 10 10 10 10 10 10 10 10 10 10 10 10 10 37 37 37 70 70 70 70 70 70
70 70 70 70 70 70 70 70 70 70 70 70 70 70 70 70 70 70 70 70 70 70 70 70 70 70 70 70 70 70 70 70 70 70 70 64 66 66 65 70 70 70 70 70 70 70 70 70 70 70 70 70 70 70 70 70 70 70 70 70 70 70 70 70 37 37 37 37 10 10 10 10 10 10 10 10 10 10 10 10 10 10 10 10 10 10 10 10 10 10 10 37 37 70 70 70 70 70 70 70
70 70 70 70 70 70 70 70 70 70 70 70 70 70 70 70 70 70 70 70 70 70 70 70 70 70 70 70 70 70 70 70 70 70 70 64 66 66 65 70 70 70 70 70 70 70 70 70 70 70 70 70 70 70 70 70 70 70 70 70 70 70 70 70 37 37 37 37 10 10 10 10 10 10 10 10 10 10 10 10 10 10 10 10 10 37 37 37 37 37 37 37 37 70 70 70 70 70 70 70
70 70 70 70 70 70 70 70 70 70 70 70 70 70 70 70 70 70 70 70 70 70 70 70 70 70 70 70 70 70 70 70 70 70 70 64 66 66 65 70 70 70 70 70 70 70 70 70 70 70 70 70 70 70 70 70 70 70 70 70 70 70 37 37 37 37 10 10 10 10 10 10 10 10 10 10 10 10 10 10 10 10 10 10 37 37 70 70 70 70 70 37 37 70 70 70 70 70 70 70
70 70 70 70 70 70 70 70 70 70 70 70 70 70 70 70 70 70 70 70 70 70 70 70 70 70 70 70 70 70 70 70 70 70 70 64 66 66 65 70 70 70 70 70 70 70 70 70 70 70 70 70 70 70 70 70 70 70 70 70 70 70 37 37 37 37 37 10 10 10 10 10 10 10 10 10 10 10 10 10 10 10 10 10 37 37 70 70 70 70 70 70 70 70 70 70 70 70 70 70
70 70 70 70 70 70 70 70 70 70 70 70 70 70 70 70 70 70 70 70 70 70 70 70 70 70 70 70 70 70 70 70 70 70 70 64 66 66 65 70 70 70 70 70 70 70 70 70 70 70 70 70 70 70 70 70 70 70 70 70 70 70 70 37 37 37 37 10 10 10 10 10 10 10 10 10 10 10 10 10 10 10 10 10 10 37 70 70 70 70 70 70 70 70 70 70 70 70 70 70
70 70 70 70 70 70 70 70 70 70 70 70 70 70 70 70 70 70 70 70 70 70 70 70 70 70 70 70 70 70 70 70 70 70 70 64 66 66 65 70 70 70 70 70 70 70 70 70 70 70 70 70 70 70 70 70 70 70 70 70 70 70 70 37 37 37 37 10 10 10 10 10 10 10 10 10 10 10 10 10 10 10 10 10 10 37 37 70 70 70 70 70 70 70 70 70 70 70 70 70
70 70 70 70 70 70 70 70 70 70 70 70 10 10 10 10 10 70 70 70 70 70 70 70 70 70 70 70 70 70 70 70 70 70 70 64 66 66 65 70 70 70 70 70 70 70 70 70 70 70 70 70 70 70 70 70 70 70 70 70 70 70 70 70 70 70 37 10 10 10 10 10 10 10 10 10 10 10 10 10 10 10 10 10 10 37 37 70 70 70 70 37 37 70 70 70 70 70 70 70
70 70 70 70 70 70 70 70 10 10 10 10 10 10 10 10 10 70 70 70 70 70 70 70 70 70 10 10 10 10 10 10 10 10 10 10 10 10 10 10 10 10 10 10 70 70 70 70 70 70 70 70 70 70 70 70 70 70 70 70 70 70 70 70 70 70 70 10 10 10 10 10 10 10 10 10 10 10 10 10 10 10 10 10 37 37 70 70 37 37 70 37 37 37 37 70 70 70 70 70
70 70 70 70 70 70 70 70 10 10 10 10 10 10 10 10 10 10 10 70 70 70 70 70 70 70 10 10 10 10 10 10 10 10 10 10 10 10 10 10 10 10 10 10 70 70 70 70 70 70 70 70 70 70 70 70 70 70 70 70 70 70 70 70 70 70 70 70 70 70 10 10 10 10 10 10 70 70 10 10 10 10 10 10 10 37 37 37 37 37 37 10 10 37 37 37 70 70 70 70
70 70 70 70 70 70 70 70 10 10 10 10 10 10 10 10 10 10 10 70 70 70 70 70 70 70 10 10 10 10 10 10 10 10 10 10 10 10 10 10 10 10 10 10 10 10 70 70 70 70 70 70 70 70 70 70 70 70 70 70 70 70 70 70 10 10 10 70 70 70 10 10 10 10 10 10 70 70 70 10 10 10 10 10 10 10 37 37 37 10 10 10 10 10 37 37 37 70 70 70
70 70 70 70 70 70 70 70 70 70 70 70 10 10 10 10 10 10 10 70 70 70 70 10 10 10 10 10 10 10 10 10 10 10 10 10 10 10 10 10 10 10 10 10 10 10 10 70 70 70 70 70 70 70 70 70 70 70 70 70 70 70 70 70 10 10 10 10 10 10 10 10 10 10 10 70 70 70 70 10 10 10 10 10 10 10 10 10 10 10 10 10 10 10 37 37 37 70 70 70
70 70 70 70 70 70 70 70 70 70 70 70 70 70 10 10 10 10 10 70 70 70 70 10 10 10 10 10 10 10 10 10 10 10 10 10 10 10 10 10 10 10 10 10 10 10 10 70 70 70 70 70 70 70 70 70 70 70 70 70 70 70 70 10 10 10 10 10 10 10 10 10 10 10 10 10 70 70 70 70 10 10 10 10 10 10 10 10 10 10 10 10 10 10 37 37 70 70 70 70
70 70 70 70 70 70 70 70 70 70 70 70 70 70 10 10 10 10 10 10 10 10 10 10 10 10 10 10 10 10 10 10 10 10 10 10 10 10 10 10 10 10 10 10 10 10 10 70 70 70 70 70 70 70 70 70 70 70 70 70 70 70 10 10 10 10 10 10 10 10 10 10 10 10 10 10 70 70 70 70 10 10 10 10 10 10 10 10 10 10 10 10 10 37 37 37 70 70 70 70
70 70 70 70 70 70 70 70 70 70 70 70 70 70 70 10 10 10 10 10 10 10 10 10 10 10 10 10 10 10 10 10 10 10 10 10 10 10 10 10 10 10 10 10 10 10 10 70 70 70 70 70 70 70 70 70 70 70 70 70 70 70 10 10 10 10 10 10 10 10 10 10 10 10 10 10 70 70 70 70 70 10 10 10 10 10 10 10 10 10 10 10 10 37 37 70 70 70 70 70
70 70 70 70 70 70 70 70 70 70 70 70 70 70 70 10 10 10 10 10 10 10 10 10 10 10 10 10 10 10 10 10 10 10 10 10 10 10 10 10 10 10 10 10 10 10 10 62 62 62 62 62 62 62 62 62 62 62 62 62 62 62 10 10 10 10 10 10 10 10 10 10 10 10 70 70 70 70 70 70 70 70 70 10 10 10 10 10 10 10 10 10 10 10 10 70 70 70 70 70
70 70 70 70 70 70 70 70 70 70 70 70 70 10 10 10 10 10 10 10 10 10 10 10 10 10 10 10 10 10 10 10 10 10 10 10 10 10 10 10 10 10 10 10 10 10 10 67 67 67 67 67 67 67 67 67 67 67 67 67 67 67 10 10 10 10 10 10 10 10 10 10 10 10 70 70 70 70 70 70 70 70 70 10 10 10 10 10 10 10 10 10 10 10 10 10 10 10 70 70
70 70 70 70 70 70 70 70 70 10 10 10 10 10 10 10 10 10 10 10 10 10 10 10 10 10 10 10 10 10 10 10 10 10 10 10 10 10 10 10 10 10 10 10 10 10 10 63 63 63 63 63 63 63 63 63 63 63 63 63 63 63 10 10 10 10 10 10 10 10 10 10 10 10 70 70 70 70 70 70 70 70 70 10 10 10 10 10 10 10 10 10 10 10 10 10 10 10 70 70
70 70 70 70 70 70 70 70 10 10 10 10 10 10 10 10 10 10 10 10 10 10 10 10 10 10 10 10 10 10 10 10 10 10 10 10 10 10 10 10 10 10 10 10 10 10 10 70 70 70 70 70 70 70 70 70 70 70 70 70 70 70 10 10 10 10 10 10 10 10 10 10 10 10 10 70 70 70 70 70 70 10 10 10 10 10 10 10 10 10 10 10 10 10 10 10 10 10 70 70
70 70 70 70 70 70 70 70 10 10 10 10 10 10 10 10 10 10 10 10 70 70 70 10 10 10 10 10 10 10 10 10 10 10 10 10 10 10 10 10 10 10 10 10 10 10 10 70 70 70 70 70 70 70 70 70 70 70 70 70 10 10 10 10 10 10 10 10 10 10 10 10 10 10 10 70 70 70 70 70 70 10 10 10 10 10 10 10 10 10 10 10 10 10 10 70 70 70 70 70
70 70 70 70 70 70 70 70 10 10 10 10 10 10 10 10 10 10 10 10 70 70 70 10 10 10 10 10 10 10 10 10 10 10 10 10 10 10 10 10 10 10 10 10 10 10 10 70 70 70 70 70 70 70 70 70 70 70 70 70 10 10 10 10 10 10 10 10 10 10 10 10 10 10 10 70 70 70 70 70 70 10 10 10 10 10 10 10 10 10 10 10 10 10 10 70 70 70 70 70
70 70 70 70 70 70 10 10 10 10 10 10 10 10 70 70 70 70 70 70 70 70 70 70 10 10 10 10 10 10 10 10 10 10 10 10 10 10 10 10 10 10 10 10 10 10 10 70 70 70 70 70 70 70 70 70 70 70 70 70 10 10 10 10 10 10 70 70 70 70 70 10 10 70 70 70 70 70 70 70 70 70 10 10 10 10 10 10 70 70 70 10 10 10 10 70 70 70 70 70
70 70 70 70 70 70 10 10 10 10 10 10 10 10 70 70 70 70 70 70 70 70 70 70 70 70 10 10 10 10 10 10 10 10 10 10 10 10 10 10 10 10 10 10 70 70 70 70 70 70 70 70 70 70 70 70 70 70 70 70 70 70 10 10 10 10 70 70 70 70 10 10 10 70 70 70 70 70 70 70 70 70 10 10 70 70 70 70 70 70 70 70 70 70 70 70 70 70 70 70
70 70 70 70 70 70 10 10 10 10 10 10 10 10 70 70 70 70 70 70 70 70 70 70 70 70 10 10 10 10 10 10 10 10 10 10 10 10 10 10 10 10 10 10 70 70 70 70 70 70 70 70 70 70 70 70 70 70 70 70 70 70 70 70 70 70 70 70 70 70 10 10 10 10 10 70 70 70 70 70 70 70 70 70 70 70 70 70 70 70 70 70 70 70 70 70 70 70 70 70
70 70 70 70 70 70 70 70 70 70 70 70 70 70 70 70 70 70 70 70 70 70 70 70 70 70 70 70 70 70 70 70 70 70 70 70 10 10 10 10 10 10 10 70 70 70 70 70 70 70 70 70 70 70 70 70 70 70 70 70 70 70 70 70 70 70 70 70 70 70 10 10 10 10 10 70 70 70 70 70 70 70 70 70 70 70 70 70 70 70 70 70 70 70 70 70 70 70 70 70
70 70 70 70 70 70 70 70 70 70 70 70 70 70 70 70 70 70 70 70 70 70 70 70 70 70 70 70 70 70 70 70 70 70 70 70 70 70 70 70 70 70 70 70 70 70 70 70 70 70 70 70 70 70 70 70 70 70 70 70 70 70 70 70 70 70 70 70 70 70 70 70 70 70 70 70 70 70 70 70 70 70 70 70 70 70 70 70 70 70 70 70 70 70 70 70 70 70 70 70
70 70 70 70 70 70 70 70 70 70 70 70 70 70 70 70 70 70 70 70 70 70 70 70 70 70 70 70 70 70 70 70 70 70 70 70 70 70 70 70 70 70 70 70 70 70 70 70 70 70 70 70 70 70 70 70 70 70 70 70 70 70 70 70 70 70 70 70 70 70 70 70 70 70 70 70 70 70 70 70 70 70 70 70 70 70 70 70 70 70 70 70 70 70 70 70 70 70 70 70