70 70 70 70 70 70 70 70 70 70 70 70 70 70 70 70 70 70 70 70 70 70 70 70 70 70 70 70 70 70 70 70 70 70 70 70 70 70 70 70 70 70 70 70 70 70 70 70 70 70 70 70 70 70 70 70 70 70 70 70 70 70 70 70 70 70 70 70 70 70 70 70 70 70 70 70 70 70 70 70 70 70 70 70 70 70 70 70 70 70 70 70 70 70 70 70 70 70 70 70
70 70 70 70 70 70 70 70 70 70 70 70 70 70 70 70 70 70 70 70 70 70 70 70 70 70 70 70 70 70 70 70 70 70 70 70 70 70 70 70 70 70 70 70 70 70 70 70 70 70 70 70 70 70 70 70 70 70 70 70 70 70 70 70 70 70 70 70 70 70 70 70 70 70 70 70 70 70 70 70 70 70 70 70 70 70 70 70 70 70 70 70 70 70 70 70 70 70 70 70
70 70 70 70 70 70 70 70 70 70 70 70 70 70 70 70 70 70 70 70 70 70 70 70 70 70 70 70 70 70 70 70 70 70 70 70 70 70 70 70 70 70 70 70 70 70 70 70 70 70 70 70 70 70 70 70 70 70 70 70 70 70 70 70 70 70 70 70 70 70 70 70 70 70 70 70 70 70 70 70 70 70 70 70 70 70 70 70 70 70 70 70 70 70 70 70 70 70 70 70
70 70 70 70 70 70 70 70 70 70 70 70 70 70 70 70 70 70 70 70 70 70 70 70 70 70 70 70 70 70 70 70 70 70 70 70 70 70 70 70 70 70 70 70 70 70 70 70 70 70 70 70 70 70 70 70 70 70 70 70 70 70 70 70 70 70 70 70 70 70 70 70 70 70 70 70 70 70 70 70 70 70 70 70 70 70 70 70 70 70 70 70 70 70 70 70 70 70 70 70
70 70 70 70 70 70 70 70 70 70 70 70 70 70 70 70 70 70 70 70 70 70 70 70 70 70 70 70 70 70 70 70 70 70 70 70 70 70 70 70 70 70 70 70 70 70 70 70 70 70 70 70 70 70 70 70 70 70 70 70 70 70 70 70 70 70 70 70 70 70 70 70 70 70 70 70 70 70 70 70 70 70 70 70 70 70 70 70 70 70 70 70 70 70 70 70 70 70 70 70
70 70 70 70 70 70 70 70 70 70 70 70 70 70 70 70 70 70 70 70 70 70 70 70 70 70 70 70 70 70 70 70 70 70 47 46 70 70 70 70 70 70 70 70 70 70 70 70 70 70 70 70 70 70 70 70 70 70 70 70 70 70 70 70 70 70 70 70 70 70 70 70 70 70 70 70 70 70 70 70 70 70 70 70 70 70 70 70 70 70 70 70 70 70 70 70 70 70 70 70
70 70 70 70 70 70 70 70 70 70 70 70 70 70 70 70 70 70 70 70 70 70 70 70 70 70 70 70 70 70 47 39 39 39 44 45 39 46 70 70 70 70 70 70 70 70 70 70 70 70 70 70 70 70 70 70 70 70 70 70 70 70 70 70 70 70 70 70 70 70 70 70 70 70 70 70 70 70 70 70 70 70 70 70 70 70 70 70 70 70 70 70 70 70 70 70 70 70 70 70
70 70 70 70 70 70 70 70 70 70 70 70 70 70 70 70 70 70 70 70 70 70 70 70 70 70 70 70 70 21 44 37 37 37 37 37 37 45 39 39 39 39 46 70 47 39 39 46 70 70 70 70 70 70 70 70 70 70 70 70 70 70 70 70 70 70 70 70 70 70 70 70 70 70 70 70 70 70 70 70 70 70 70 70 70 70 70 70 70 70 70 70 70 70 70 70 70 70 70 70
70 70 70 70 70 70 70 70 70 70 70 70 70 70 70 70 70 70 70 70 70 70 70 70 70 70 70 70 70 15 51 51 51 51 51 51 54 37 37 37 37 37 45 39 44 37 37 45 46 70 70 70 70 70 70 70 70 70 70 70 70 70 70 70 70 70 70 70 70 70 70 70 70 70 70 70 70 70 70 70 70 70 70 70 70 70 70 70 70 70 70 70 70 70 70 70 70 70 70 70
70 70 70 70 70 70 70 70 70 70 70 70 70 70 70 70 70 70 70 70 70 70 70 70 70 70 70 70 70 15 10 10 10 10 10 10 61 51 54 37 37 37 37 37 37 37 37 37 45 39 46 70 70 70 70 70 70 47 39 39 46 70 70 70 70 70 70 70 70 70 70 70 70 70 70 70 70 70 70 70 70 70 70 70 70 70 70 70 70 70 70 70 70 70 70 70 70 70 70 70
70 70 70 70 70 70 70 70 70 70 70 70 70 70 70 70 70 70 70 70 70 21 13 13 13 13 13 13 13 18 10 10 11 10 10 10 10 10 61 51 51 51 51 51 51 51 54 37 37 37 45 46 70 70 70 70 47 44 37 37 45 39 46 70 70 70 70 70 70 70 70 70 70 70 70 70 70 70 70 70 70 70 70 70 70 70 70 70 70 70 70 70 70 70 70 70 70 70 70 70
70 70 70 70 70 70 70 70 70 70 70 70 70 70 70 70 70 70 70 70 70 15 10 10 10 10 10 10 10 10 10 10 10 10 10 10 10 10 10 10 10 10 10 10 10 10 52 37 37 37 37 45 46 70 70 47 44 37 37 37 37 37 45 39 39 39 39 39 39 46 70 70 70 70 70 70 70 70 70 70 21 20 70 70 70 70 70 70 70 70 70 70 21 13 20 70 70 70 70 70
70 70 70 70 70 70 70 70 70 70 70 70 70 70 70 70 70 70 21 13 13 18 10 10 10 11 10 11 10 10 10 10 10 10 10 10 10 10 10 10 10 10 10 10 10 10 52 37 37 37 37 37 45 39 39 44 37 37 37 37 37 37 37 37 37 37 37 37 37 45 39 46 70 70 70 70 70 70 21 13 18 19 20 70 70 70 70 70 70 70 21 13 18 10 14 70 70 70 70 70
70 70 70 70 70 70 70 70 70 70 70 70 70 70 70 70 70 70 15 10 10 10 10 10 10 10 10 10 10 10 10 10 10 10 10 10 10 10 10 10 10 10 10 10 10 10 61 54 37 37 37 37 37 37 37 37 37 37 55 51 51 54 37 37 37 37 37 37 37 37 37 45 39 39 39 13 13 13 18 10 10 10 19 20 70 70 70 70 70 21 18 10 10 10 19 13 20 70 70 70
70 70 70 70 70 70 70 70 70 70 70 70 70 70 70 70 70 21 18 10 10 10 10 10 10 10 10 10 10 10 10 10 10 10 10 10 10 10 10 10 10 10 10 10 10 10 10 61 51 51 51 51 51 51 51 51 51 51 60 10 10 61 51 51 51 51 51 51 54 37 37 37 37 37 37 53 10 10 10 10 10 10 10 19 62 62 62 62 13 18 10 10 10 10 10 10 14 70 70 70
70 70 70 70 70 70 70 70 70 70 70 70 70 70 70 70 21 18 10 10 10 10 10 10 10 10 10 10 10 10 10 10 10 10 10 10 10 10 10 10 10 10 10 10 10 10 10 10 10 10 10 10 10 10 10 10 10 10 10 10 10 10 10 10 10 10 10 10 61 51 51 51 51 51 51 60 10 10 10 10 10 10 10 10 67 67 67 67 10 10 10 10 10 10 10 10 14 70 70 70
70 70 70 70 70 70 70 70 70 70 70 70 70 70 70 70 15 10 10 10 10 10 10 10 10 10 10 10 10 10 10 10 10 10 10 10 10 10 10 10 10 10 10 10 10 10 10 10 10 10 10 10 10 10 10 10 10 10 10 11 10 11 10 10 10 10 10 11 10 10 10 10 10 10 10 10 10 10 17 12 12 12 12 12 63 63 63 63 16 10 10 10 10 10 10 10 14 70 70 70
70 70 70 70 70 70 70 70 70 70 70 70 70 70 70 70 15 10 10 10 10 10 10 10 10 10 10 10 10 10 10 10 10 10 10 10 10 10 10 10 10 10 10 10 10 10 10 10 10 10 10 10 10 10 10 10 10 10 10 11 10 10 10 10 10 10 10 10 10 10 10 10 10 10 10 10 10 10 14 70 70 70 70 70 70 70 70 70 15 10 10 10 10 10 10 10 14 70 70 70
70 70 70 70 70 70 70 70 70 70 70 70 70 70 70 70 15 10 10 10 10 10 10 10 10 10 10 10 10 10 10 10 11 10 10 10 10 10 10 10 10 10 10 10 10 10 10 10 10 10 10 10 10 10 10 10 10 10 10 10 10 10 10 10 10 10 10 10 10 10 10 10 10 59 50 50 58 17 22 70 70 70 70 70 70 70 70 70 23 16 10 10 10 10 10 10 14 70 70 70
70 70 70 70 70 70 70 70 70 70 70 70 70 70 70 70 23 12 12 12 16 10 10 10 10 10 10 10 10 10 10 10 10 10 10 10 10 10 10 11 10 10 10 10 10 10 10 10 10 10 10 10 10 10 10 10 10 10 10 10 10 59 50 50 50 50 58 10 10 10 10 10 59 56 37 37 37 40 70 70 70 70 70 70 70 70 70 70 70 15 10 10 10 10 10 10 14 70 70 70
70 70 70 70 70 70 70 70 70 70 70 70 70 70 70 70 70 70 70 70 23 12 12 16 10 10 10 10 10 10 10 10 10 10 10 10 10 10 10 10 10 10 10 10 10 10 10 10 10 10 10 10 10 10 10 10 10 10 11 10 59 56 43 38 38 42 57 50 50 50 50 50 56 37 37 37 43 48 70 70 70 70 70 70 70 70 70 70 70 23 16 10 10 10 10 10 14 70 70 70
70 70 70 70 70 70 70 70 70 70 70 70 70 70 70 70 70 70 70 70 70 70 70 15 10 10 10 10 10 10 10 10 10 10 10 10 10 10 10 10 10 10 10 10 10 10 10 10 10 10 10 10 10 10 10 10 10 10 10 10 52 43 48 70 70 41 37 37 37 37 37 37 37 37 43 38 48 70 70 70 70 70 70 70 70 70 70 70 70 70 23 12 12 16 10 17 22 70 70 70
70 70 70 70 70 70 70 70 70 70 70 70 70 70 70 70 70 70 70 70 70 70 21 18 10 10 10 10 10 10 10 10 10 10 10 10 10 10 11 10 10 10 10 10 11 10 10 10 10 10 10 10 10 11 10 10 10 10 10 10 52 40 70 70 70 49 42 37 37 37 37 37 37 43 48 70 70 70 70 70 70 70 70 70 70 70 70 70 70 70 70 70 70 15 10 14 70 70 70 70
70 70 70 70 70 70 70 70 70 70 70 70 70 70 70 70 70 70 70 70 70 70 23 12 12 12 16 10 10 10 10 10 10 10 10 10 10 10 10 10 10 10 10 10 10 10 10 10 10 10 10 10 10 11 10 10 10 10 10 10 52 40 70 70 70 70 49 42 37 37 37 37 37 40 70 70 70 70 70 71 70 70 70 70 70 70 70 70 70 70 70 70 70 15 10 14 70 70 70 70
70 70 70 70 70 70 70 70 70 70 70 70 70 70 70 70 70 70 70 70 70 70 70 70 70 70 15 10 10 10 10 10 10 11 10 10 10 10 10 10 10 10 10 10 10 10 10 10 10 10 10 10 10 10 10 10 11 10 10 10 10 19 20 70 70 70 70 49 38 38 38 38 38 48 70 70 70 70 71 70 70 70 70 70 70 70 70 70 70 70 70 70 70 23 12 22 70 70 70 70
70 70 70 70 70 70 70 70 70 70 70 70 70 70 70 70 70 70 70 70 70 70 70 70 70 70 15 10 10 10 10 10 10 10 10 10 10 10 10 10 10 10 10 10 10 10 10 10 10 10 10 10 10 10 10 10 10 10 10 10 10 10 14 70 70 70 70 70 70 70 70 70 70 70 70 70 71 70 70 70 70 70 70 70 70 70 70 70 70 70 70 70 70 70 70 70 70 70 70 70
70 70 70 70 70 70 70 70 70 70 70 70 70 70 70 70 70 70 70 70 70 70 70 71 70 70 15 10 10 10 10 10 10 10 10 10 10 10 10 10 11 10 10 10 10 10 10 10 10 10 10 10 10 10 10 10 10 10 10 10 10 10 19 20 70 70 70 70 70 70 70 70 70 70 70 70 70 70 70 70 70 70 70 70 70 70 70 70 70 70 70 70 70 70 70 70 70 70 70 70
70 70 70 70 70 70 70 70 70 70 70 70 70 47 39 39 39 39 46 70 70 70 70 70 70 70 15 10 10 10 10 10 10 10 10 10 10 10 10 10 10 10 10 10 10 10 10 10 10 10 10 10 10 10 10 10 10 10 10 10 10 10 10 14 70 70 70 70 70 70 70 70 70 70 70 70 70 70 70 70 70 70 70 70 70 70 70 70 70 70 70 70 70 70 70 70 70 70 70 70
70 70 70 70 70 70 70 70 70 70 47 39 39 44 37 37 37 37 45 46 70 70 70 70 70 70 15 10 10 10 10 10 10 10 10 10 10 10 10 10 10 10 10 10 10 10 10 10 10 10 10 10 10 10 10 10 10 10 10 10 10 10 10 19 20 70 70 70 70 71 70 70 70 70 70 70 71 70 70 70 70 70 70 70 70 70 70 70 70 70 70 70 70 70 70 70 70 70 70 70
70 70 70 70 70 70 70 70 47 39 44 37 55 51 51 51 51 51 54 45 39 46 70 70 70 70 15 10 10 10 10 10 10 10 10 10 10 10 10 10 10 10 10 10 10 10 10 10 10 10 10 10 10 10 10 10 10 10 10 10 11 10 10 10 19 20 70 70 70 70 70 70 71 70 70 70 70 70 70 70 70 70 70 70 70 70 70 70 70 70 70 70 70 70 70 70 70 70 70 70
70 70 70 70 70 70 70 70 41 37 55 51 60 10 10 10 10 10 61 51 51 19 13 13 13 13 18 10 10 11 10 10 10 10 10 10 10 10 10 10 10 10 10 10 10 10 10 10 10 10 10 10 10 10 11 10 10 10 10 10 10 10 10 10 10 14 70 70 70 70 70 70 70 70 70 70 70 70 70 70 70 70 70 70 70 70 70 70 70 70 70 70 70 70 70 70 70 70 70 70
70 70 70 70 70 70 70 47 44 37 53 10 10 10 10 10 10 10 10 10 10 10 10 10 10 10 10 10 10 10 10 10 10 10 10 10 10 10 10 10 10 10 10 10 10 10 10 10 10 10 10 10 10 10 10 10 10 10 10 10 10 10 10 10 10 19 20 70 70 70 70 70 71 70 70 70 70 70 70 70 70 70 70 70 70 70 70 70 70 70 70 70 70 70 70 70 70 70 70 70
70 70 70 70 70 70 70 41 37 37 57 58 10 10 10 10 10 10 10 11 10 10 10 10 10 10 10 10 10 10 10 10 10 10 10 10 10 10 10 10 17 12 12 12 12 12 12 16 10 10 10 10 10 10 10 10 10 10 10 10 10 10 10 10 10 10 14 70 70 70 70 70 70 70 70 70 70 71 70 70 70 70 70 70 70 70 70 70 70 70 70 70 70 70 70 70 70 70 70 70
70 70 70 70 70 70 70 49 42 37 37 53 10 10 10 10 11 11 10 10 10 10 10 10 10 10 10 10 10 10 10 10 10 10 10 10 10 10 10 10 14 70 70 70 70 70 70 23 12 12 16 10 10 10 10 10 10 10 10 11 10 10 10 10 10 10 19 13 20 70 70 70 70 70 70 70 70 70 70 70 70 70 70 70 70 70 70 70 70 70 70 70 70 70 70 70 70 70 70 70
70 70 70 70 70 70 70 70 41 37 37 53 10 10 10 10 10 10 10 10 10 10 10 10 10 10 10 10 10 10 10 17 12 12 12 12 12 12 12 12 22 70 70 70 70 70 70 70 70 70 15 10 10 10 10 10 10 10 10 10 10 10 10 10 10 10 10 10 14 70 70 70 70 70 70 70 70 70 70 70 70 70 70 70 70 70 70 70 70 70 70 70 70 70 70 70 70 70 70 70
70 70 70 70 70 70 70 70 41 37 37 53 10 10 10 10 10 10 10 10 10 10 10 34 33 10 10 10 10 10 10 14 70 70 70 70 70 70 70 70 70 70 70 70 70 70 70 70 70 70 23 16 10 10 10 10 10 10 10 10 10 10 10 10 10 10 10 10 19 13 20 70 70 70 70 70 21 13 13 20 70 70 70 70 70 70 70 70 70 70 70 70 70 70 70 70 70 70 70 70
70 70 70 70 70 70 70 70 41 37 55 60 10 10 10 10 10 10 10 10 10 10 10 28 27 10 10 10 10 10 10 14 70 70 70 70 71 70 70 70 70 70 70 70 70 71 71 70 70 70 70 15 10 17 12 16 10 10 10 10 10 10 10 10 10 10 10 10 10 10 14 70 70 70 70 70 15 10 10 14 70 70 70 70 70 70 70 70 70 70 70 70 70 70 70 70 70 70 70 70
70 70 70 70 70 70 70 47 44 37 53 10 10 10 10 10 10 10 10 10 10 10 10 28 27 10 10 10 10 10 10 14 70 70 71 71 70 70 70 70 70 70 70 70 70 70 70 70 70 70 70 23 12 22 70 15 10 10 10 10 10 10 10 10 10 10 10 17 12 12 22 70 70 71 70 70 23 12 16 19 13 13 13 20 70 70 70 70 70 70 70 70 70 70 70 70 70 70 70 70
70 70 70 70 70 70 70 41 37 37 57 50 50 50 50 50 50 58 10 10 10 10 10 28 27 10 10 10 10 11 10 14 70 70 70 70 70 70 70 71 70 70 70 70 70 70 70 70 70 70 70 70 70 70 70 23 12 16 10 10 10 10 10 10 10 10 17 22 70 70 70 70 70 70 70 70 70 70 15 10 10 10 10 14 70 70 70 70 70 70 70 70 70 70 70 70 70 70 70 70
70 70 70 70 70 70 70 49 42 37 37 37 37 37 37 37 37 57 58 10 10 10 10 28 27 10 10 10 10 10 10 19 20 70 70 70 70 70 70 70 70 70 70 70 70 70 70 71 71 70 70 70 70 70 70 70 70 15 10 10 17 12 16 10 10 10 14 70 70 70 70 70 70 70 70 70 70 70 15 10 10 10 10 19 20 70 70 70 70 70 70 70 70 70 70 70 70 70 70 70
70 70 70 70 70 70 70 70 49 38 38 42 37 37 37 37 37 37 57 10 10 10 10 28 27 10 10 10 10 10 10 10 14 70 70 70 70 70 70 70 70 70 70 70 70 70 70 70 70 70 70 70 70 70 70 70 70 23 12 16 14 70 23 12 12 16 14 70 70 70 70 70 70 71 70 70 70 70 15 10 10 10 10 10 14 70 70 70 70 70 70 70 70 70 70 70 70 70 70 70
70 70 70 70 70 70 70 70 70 70 70 49 38 38 38 38 38 38 38 16 10 10 10 28 27 10 10 10 10 10 10 10 19 13 13 13 20 70 70 70 70 70 70 70 70 70 70 70 70 70 70 70 70 70 70 70 70 70 70 23 22 70 70 70 70 23 22 70 71 71 70 70 71 70 70 70 70 70 15 10 10 10 10 17 22 70 70 70 70 70 70 70 70 70 70 70 70 70 70 70
70 70 70 70 70 70 70 71 70 70 70 70 70 70 70 70 70 70 70 15 10 10 10 28 27 10 10 10 10 10 11 10 10 10 10 10 19 13 13 13 13 20 70 70 70 70 70 70 70 71 70 70 70 70 70 70 70 70 70 70 70 70 70 70 70 70 71 70 71 70 70 70 70 70 70 71 70 70 23 16 10 17 12 22 70 70 70 70 70 70 70 70 70 70 70 70 70 70 70 70
70 70 70 70 70 70 70 70 70 70 70 70 70 70 70 70 70 70 70 15 10 10 10 28 27 10 10 10 10 10 10 10 10 10 10 10 10 10 10 10 10 14 70 70 70 70 70 70 70 70 70 70 70 70 70 70 70 70 70 70 70 70 71 70 70 70 70 70 70 70 70 21 20 70 70 70 70 70 70 15 10 14 70 70 70 70 70 70 70 70 70 70 70 70 70 70 70 70 70 70
70 70 70 70 70 70 47 39 39 39 39 39 39 39 46 70 70 70 70 15 10 10 10 28 27 10 10 10 10 10 10 10 10 10 10 10 10 10 10 10 10 14 70 70 70 70 70 70 70 70 70 70 70 70 70 70 70 70 70 70 70 70 71 70 70 70 70 70 70 70 70 15 19 13 13 13 13 13 13 18 10 14 70 70 70 70 70 70 70 70 70 70 70 70 70 70 70 70 70 70
70 70 70 70 47 39 44 37 37 37 37 37 37 37 45 39 39 39 39 18 10 10 10 28 27 10 10 10 10 10 10 10 10 10 10 10 10 10 10 10 10 19 20 70 70 70 70 70 70 70 70 70 70 70 70 70 70 70 70 70 70 70 70 70 70 70 70 70 70 70 70 15 10 10 10 10 10 10 10 10 10 14 70 70 70 70 70 70 70 70 70 70 70 70 70 70 70 70 70 70
70 70 70 70 41 37 37 37 55 51 51 54 37 37 37 37 37 37 55 10 10 10 10 28 27 10 10 10 10 10 10 10 10 10 10 10 10 11 10 10 10 10 19 13 13 13 13 20 70 70 70 70 70 70 70 70 70 70 70 70 70 70 70 70 70 70 70 70 70 70 70 15 10 10 10 10 10 10 10 10 10 14 70 70 70 70 70 70 70 70 70 70 70 70 70 70 70 70 70 70
70 70 70 70 41 37 37 55 60 10 10 61 51 51 51 51 51 51 60 10 10 10 10 28 32 26 26 26 26 26 33 10 10 10 10 10 10 10 10 10 10 10 10 10 10 10 10 14 70 70 70 70 70 70 70 70 70 70 70 71 70 70 70 70 71 70 70 70 70 70 21 18 10 10 10 10 10 10 10 10 10 14 70 70 70 21 20 70 70 70 70 70 70 70 70 70 70 70 70 70
70 70 70 70 41 37 37 53 10 10 10 10 10 10 10 10 10 10 10 10 10 10 10 36 25 25 25 25 25 29 27 10 10 10 10 10 10 10 10 10 10 10 10 10 10 10 10 19 13 13 13 20 70 70 70 70 70 70 70 70 70 70 70 70 70 70 70 70 70 21 18 10 10 10 10 10 10 10 10 10 10 14 70 70 70 15 19 13 13 13 20 70 70 70 70 70 70 70 70 70
70 70 70 70 41 37 37 57 58 10 10 10 10 10 10 10 10 10 10 10 10 10 10 10 10 10 10 10 10 28 32 26 26 26 26 26 26 26 26 26 26 26 26 26 26 26 33 10 10 10 10 19 13 62 62 62 62 62 62 62 62 62 62 62 62 62 62 62 62 18 10 10 10 10 10 10 10 10 10 10 10 19 13 13 13 18 10 10 10 10 14 70 70 70 70 70 70 70 70 70
70 70 70 70 41 37 37 37 53 10 10 10 10 10 10 10 10 10 10 10 10 10 10 10 10 10 10 10 10 28 30 25 25 25 25 25 25 25 25 25 25 25 25 25 25 25 35 10 10 10 10 10 10 67 67 67 67 67 67 67 67 67 67 67 67 67 67 67 67 10 10 10 10 10 10 10 10 10 10 10 10 10 10 10 10 10 10 10 10 10 14 70 70 70 70 70 70 70 70 70
70 70 70 70 49 42 37 37 53 10 10 10 10 10 10 10 10 10 10 10 11 10 10 10 10 10 10 10 10 28 27 10 10 10 10 10 10 10 10 10 10 10 10 10 10 10 10 10 10 10 10 17 12 63 63 63 63 63 63 63 63 63 63 63 63 63 63 63 63 16 10 10 10 10 10 10 10 10 10 10 10 10 17 12 12 16 10 10 10 10 14 70 70 70 70 70 70 70 70 70
70 70 70 70 70 41 37 37 53 10 10 10 10 10 10 10 10 10 10 10 10 10 10 10 10 10 10 10 10 28 27 10 10 10 10 10 10 10 10 10 10 10 10 10 10 10 10 10 10 10 10 14 70 70 70 70 70 70 70 70 70 71 70 70 70 71 71 70 70 23 12 16 10 10 10 10 10 10 10 10 10 10 14 70 70 15 10 10 10 10 14 70 70 70 70 70 70 70 70 70
70 70 70 70 70 41 37 55 60 10 10 10 10 10 10 10 10 10 10 10 10 10 10 10 10 10 10 10 10 28 27 10 10 10 10 10 10 10 10 10 10 10 10 10 10 10 10 10 10 10 10 14 70 70 70 70 70 71 71 70 70 70 70 70 70 70 70 70 70 70 70 23 12 12 12 16 10 10 10 10 10 10 14 70 70 23 12 12 12 16 14 70 70 70 70 70 70 70 70 70
70 70 70 70 70 41 37 53 10 10 10 10 10 10 10 10 10 10 10 10 10 10 10 10 10 10 10 10 10 28 27 10 10 10 10 10 10 10 10 10 10 10 10 10 10 10 10 10 10 10 10 19 39 39 39 46 70 70 70 71 70 70 70 70 70 70 70 70 70 70 70 70 70 70 70 15 10 10 10 10 10 10 14 70 70 70 70 70 70 23 22 70 70 70 70 70 70 70 70 70
70 70 70 70 47 44 37 53 10 10 10 10 10 10 10 10 10 11 11 10 10 10 10 10 10 10 10 10 10 28 27 10 10 10 10 10 10 10 10 10 10 10 10 10 10 10 10 10 10 10 10 10 51 54 37 40 70 70 70 70 70 71 70 70 70 70 70 70 70 70 70 70 70 70 70 23 12 16 10 10 10 10 19 20 70 70 70 70 70 70 70 70 70 70 70 70 70 70 70 70
70 70 70 70 41 37 37 53 10 10 10 10 10 10 10 10 10 10 10 10 10 10 10 10 10 10 10 10 10 28 27 10 10 10 10 10 10 10 10 10 10 10 10 10 10 10 10 10 10 10 10 10 10 52 37 45 39 46 70 70 70 70 70 70 70 70 71 70 70 70 70 70 70 71 70 70 70 23 12 12 12 12 16 14 70 70 70 70 70 70 70 70 70 70 70 70 70 70 70 70
70 70 70 70 41 37 37 57 50 58 10 10 10 10 10 10 10 10 10 10 10 10 10 10 10 10 10 10 10 28 27 10 10 10 10 10 10 10 10 10 10 10 10 10 10 10 10 10 10 10 10 10 10 61 51 54 37 45 39 46 70 70 70 70 71 70 70 70 70 70 70 70 70 70 70 70 70 70 70 70 70 70 15 14 70 70 70 70 70 70 70 70 70 70 70 70 70 70 70 70
70 70 70 70 41 37 37 37 37 57 50 50 50 50 58 10 10 10 10 10 10 10 10 10 10 10 10 10 10 28 32 26 26 26 26 26 26 33 10 10 10 10 10 10 10 10 10 10 10 10 10 10 10 10 10 52 37 37 37 40 70 70 70 70 70 70 70 70 70 70 70 70 70 70 70 70 70 70 70 70 70 70 23 22 70 70 70 70 70 70 70 70 70 70 70 70 70 70 70 70
70 70 70 70 49 38 42 37 37 37 37 37 37 37 57 50 58 10 10 10 10 10 10 10 10 10 10 10 10 28 30 25 25 25 25 25 29 27 10 10 10 10 10 10 10 10 10 10 10 10 10 10 10 10 10 52 37 37 37 40 70 70 70 70 70 70 70 70 70 70 71 71 70 70 71 70 70 70 70 70 71 70 70 70 70 70 70 70 70 70 70 70 70 70 70 70 70 70 70 70
70 70 70 70 70 70 41 37 37 37 37 37 37 37 37 37 57 50 50 58 10 10 10 10 10 10 10 10 10 28 27 10 10 10 10 10 28 27 10 10 10 10 10 10 10 10 10 10 10 10 10 10 10 59 50 56 37 43 38 48 70 70 70 70 70 70 70 70 70 70 70 70 70 70 70 70 70 70 71 70 70 70 70 70 70 70 70 70 70 70 70 70 70 70 70 70 70 70 70 70
70 70 70 70 70 70 49 38 38 38 42 37 37 37 37 37 37 37 37 53 10 10 10 10 10 10 10 10 10 28 27 10 10 10 10 10 28 27 10 10 10 10 10 10 10 10 10 10 10 10 10 10 59 56 37 37 37 40 70 70 70 70 70 70 71 70 70 70 70 70 70 70 70 70 70 70 70 70 70 71 70 70 70 70 70 70 70 70 70 70 70 70 70 70 70 70 70 70 70 70
70 70 70 70 70 70 70 70 70 70 49 38 38 38 38 42 37 37 37 53 10 10 10 10 10 10 10 10 10 28 27 10 10 10 10 10 28 27 10 10 10 10 10 11 10 10 10 10 59 50 50 50 56 37 37 37 37 40 70 70 70 70 70 70 70 70 70 70 70 70 70 70 70 70 70 70 70 70 70 70 70 70 70 70 70 70 70 70 70 70 70 70 70 70 70 70 70 70 70 70
70 70 70 70 70 70 70 70 70 70 70 70 70 70 70 49 38 42 37 53 10 10 10 10 10 10 10 10 10 28 27 10 10 10 10 10 28 27 10 10 10 10 10 10 10 10 10 59 56 37 37 37 37 37 37 37 37 40 70 70 71 70 70 70 70 70 70 70 70 70 70 70 70 70 70 70 70 70 70 70 70 70 70 70 70 70 70 70 70 70 70 70 70 70 70 70 70 70 70 70
70 70 70 70 70 70 70 70 70 70 70 70 70 70 70 70 70 41 37 53 10 10 10 10 10 10 10 10 10 28 27 10 10 10 10 10 28 27 10 10 10 10 10 10 10 10 10 52 37 37 37 37 37 43 38 38 38 48 70 70 70 70 70 70 70 70 70 70 70 70 70 70 70 70 70 70 70 70 70 70 70 70 70 70 70 70 70 70 70 70 70 70 70 70 70 70 70 70 70 70
70 70 70 70 70 70 70 70 70 70 70 70 70 70 70 70 70 41 37 53 10 10 10 10 10 10 10 10 10 36 35 10 10 10 10 10 28 27 10 10 10 10 10 10 10 10 10 52 37 37 37 37 37 40 70 70 70 70 70 70 70 71 70 70 70 71 70 70 70 70 47 39 39 46 70 70 70 70 71 70 70 70 70 70 70 70 70 70 70 70 70 70 70 70 70 70 70 70 70 70
70 70 70 70 70 70 70 70 70 70 70 70 70 70 70 70 70 41 37 53 10 10 10 10 10 10 10 10 10 10 10 10 10 10 10 10 28 27 10 10 10 10 10 10 10 59 50 56 37 37 37 37 37 45 46 70 70 70 70 70 70 70 70 70 70 70 70 70 47 39 44 37 37 45 39 46 70 70 70 70 70 70 47 39 39 46 70 70 70 70 70 70 70 70 70 70 70 70 70 70
70 70 70 70 70 70 70 70 70 70 70 70 70 70 70 70 70 41 37 53 10 10 10 10 10 10 10 10 10 10 10 10 10 10 10 10 28 27 10 10 10 10 10 10 10 52 37 37 37 37 37 43 38 38 48 70 70 70 70 70 70 70 70 70 70 47 39 39 44 37 37 37 37 37 37 45 39 39 39 39 39 39 44 37 37 45 39 39 39 46 70 70 70 70 70 70 70 70 70 70
70 70 70 70 70 70 70 70 70 71 70 70 70 70 70 70 70 49 42 57 50 50 50 50 58 10 10 59 50 50 50 50 50 50 58 10 28 27 10 10 17 12 12 16 50 56 37 37 37 37 43 48 70 70 70 70 70 70 70 70 70 70 70 70 70 41 37 37 37 37 37 37 37 37 37 37 37 37 37 37 37 37 37 37 37 37 37 37 37 40 70 70 70 70 70 70 70 70 70 70
70 70 70 70 70 70 70 70 70 70 70 70 70 70 70 70 70 70 41 37 37 37 37 37 53 10 10 52 37 37 37 37 37 37 57 10 28 27 10 10 14 70 70 41 37 37 43 38 38 38 48 70 70 70 70 71 70 70 70 70 70 70 70 70 70 41 37 37 37 37 37 37 37 55 51 51 51 51 51 51 51 51 51 54 37 37 37 37 37 45 39 39 46 70 70 70 70 70 70 70
70 70 70 70 70 70 70 70 70 70 70 70 70 70 70 70 70 70 49 38 38 42 37 37 57 50 50 56 37 37 37 37 43 38 38 16 28 27 10 10 14 70 70 49 38 38 48 70 70 70 70 70 70 70 70 70 70 70 70 70 70 70 70 47 39 44 37 37 37 37 55 51 51 60 10 10 10 10 10 10 10 10 10 61 51 51 54 37 37 37 37 37 40 70 70 70 70 70 70 70
70 70 70 70 70 70 70 70 70 70 70 70 70 70 70 70 70 70 70 70 70 49 38 42 37 37 37 37 37 43 38 38 48 70 70 15 28 27 17 12 22 70 70 70 70 70 70 70 70 70 70 70 70 70 70 70 70 70 70 70 70 70 70 41 37 37 37 37 37 37 53 10 10 10 10 10 10 10 11 10 11 10 10 10 10 10 61 51 54 37 37 37 45 46 70 70 70 70 70 70
70 70 70 70 70 70 70 70 70 70 70 70 70 70 70 70 70 70 70 70 70 70 70 49 38 38 38 38 38 48 70 70 70 70 70 15 28 27 14 70 70 70 70 70 70 70 70 70 70 70 70 70 70 70 70 70 70 70 70 70 70 70 70 49 42 37 37 37 37 37 53 10 10 10 10 10 10 10 11 10 10 10 10 10 10 10 10 10 52 37 37 37 37 40 70 70 70 70 70 70
70 70 70 70 70 70 70 70 70 70 70 70 70 70 70 70 70 71 70 70 70 70 70 70 70 70 70 70 70 70 70 70 70 70 70 64 66 66 65 70 70 70 70 70 70 70 70 70 70 70 70 70 70 70 70 70 70 70 70 70 70 70 70 70 41 37 37 37 55 51 60 10 10 10 10 10 10 10 10 10 10 10 10 10 59 50 50 50 56 37 37 37 43 48 70 70 70 70 70 70
70 70 70 70 70 70 70 70 70 70 70 70 70 70 70 70 70 70 70 70 70 70 70 70 70 70 70 70 70 70 70 70 70 70 70 64 66 66 65 70 70 70 70 71 70 70 70 70 70 70 70 70 70 70 70 70 70 70 70 70 70 70 70 70 41 37 37 37 53 10 10 10 10 10 10 10 10 10 10 10 10 10 10 59 56 37 37 37 37 37 37 37 40 70 70 70 70 70 70 70
70 70 70 70 70 70 70 70 70 70 70 70 70 70 70 70 70 70 70 70 70 70 70 70 70 70 70 70 70 70 70 70 70 70 70 64 66 66 65 70 70 70 70 70 70 70 70 70 70 70 70 70 70 70 70 70 70 70 70 70 70 70 70 70 41 37 37 37 53 10 10 10 10 10 10 11 10 10 10 10 10 10 59 56 37 43 38 38 38 38 38 42 40 70 70 70 70 70 70 70
70 70 70 70 70 70 70 70 70 70 70 70 70 70 70 70 70 70 70 70 70 70 70 70 70 70 70 70 70 70 70 70 70 70 70 64 66 66 65 70 70 70 70 70 70 70 70 70 70 70 70 70 70 70 70 70 70 70 70 70 70 70 70 47 44 37 37 55 60 10 10 10 10 10 10 10 10 10 10 10 10 10 52 37 37 40 70 70 70 70 70 49 48 70 70 70 70 70 70 70
70 70 70 70 70 70 70 70 70 70 70 70 70 70 70 70 70 70 70 70 70 70 70 70 70 70 70 70 70 70 70 70 70 70 70 64 66 66 65 70 70 70 70 70 70 70 70 70 70 70 70 70 70 70 70 70 70 70 70 70 70 70 70 41 37 37 37 53 10 10 10 10 10 10 10 10 10 10 10 10 10 10 52 37 37 40 70 70 70 70 70 70 70 70 70 70 70 70 70 70
70 70 70 70 70 70 70 70 70 70 70 70 70 70 70 70 70 70 70 70 70 70 70 70 70 70 71 70 70 70 70 70 70 70 70 64 66 66 65 70 70 70 70 70 70 70 70 70 70 70 70 70 70 70 70 70 70 70 70 70 70 70 70 41 37 37 37 53 10 10 10 10 10 10 10 10 10 10 10 10 10 10 61 54 37 40 70 70 70 70 70 70 70 70 70 70 70 70 70 70
70 70 70 70 70 70 70 70 71 70 70 70 70 70 70 70 70 70 70 70 70 70 70 70 70 70 70 70 70 70 70 70 70 70 70 64 66 66 65 70 70 70 70 70 70 70 70 70 70 70 70 70 70 70 70 70 70 70 70 70 70 70 70 49 38 38 42 53 10 10 10 10 10 10 10 10 11 10 10 10 10 10 59 56 37 45 46 70 70 70 70 70 70 70 70 70 70 70 70 70
70 70 70 70 70 70 70 70 70 70 70 70 21 13 13 13 20 70 70 70 70 70 70 70 70 70 70 70 70 70 70 70 70 70 70 64 66 66 65 70 70 70 70 70 70 70 70 70 70 70 70 70 70 70 70 70 70 70 70 70 70 70 70 70 70 70 49 16 10 10 10 10 10 10 10 10 10 10 10 10 10 10 52 37 37 43 48 70 70 70 70 47 46 70 70 70 70 70 70 70
70 70 70 70 70 70 70 70 21 13 13 13 18 10 10 10 14 70 70 70 70 70 70 70 70 70 21 13 13 13 13 13 13 13 13 18 10 10 19 13 13 13 13 20 70 70 70 71 70 70 70 70 70 70 70 70 70 70 70 70 70 70 70 70 70 70 70 23 12 12 16 10 10 10 10 10 10 10 10 10 10 10 52 37 37 40 70 70 47 46 70 41 45 39 46 70 70 70 70 70
70 70 70 70 70 70 70 70 15 10 10 10 10 10 10 10 19 13 20 70 70 70 70 70 70 70 15 10 10 10 10 10 10 10 10 10 10 10 10 10 10 10 10 14 70 70 70 70 70 70 70 70 70 70 70 71 70 70 70 70 70 70 70 70 70 70 70 70 70 70 15 10 10 10 10 10 10 10 10 10 10 10 61 54 37 45 39 39 44 45 39 44 37 37 45 46 70 70 70 70
70 70 70 70 70 70 70 70 23 12 12 12 16 10 10 10 10 10 14 70 70 70 70 70 70 70 15 10 10 10 10 10 10 10 10 10 10 10 10 10 10 10 10 19 13 20 70 70 70 71 71 71 70 70 70 70 70 70 70 70 70 70 70 70 70 70 70 70 70 70 15 10 10 10 10 10 17 12 12 16 10 10 10 61 54 37 37 37 37 37 37 37 37 37 37 45 46 70 70 70
70 70 70 70 70 70 70 70 70 70 70 70 23 12 16 10 10 10 14 70 70 70 70 21 13 13 18 10 10 10 10 10 10 10 10 10 10 10 10 10 10 10 10 10 10 19 20 70 70 70 71 70 70 70 70 70 70 70 70 70 70 70 70 70 21 13 13 13 13 13 18 10 10 10 10 17 22 71 70 23 16 10 10 10 61 51 51 51 51 51 54 37 37 37 37 43 48 70 70 70
70 70 70 70 70 70 70 70 70 70 70 70 70 70 15 10 10 10 14 70 70 70 70 15 10 10 10 10 10 10 10 10 10 10 10 10 10 10 10 10 10 10 10 10 10 10 14 70 70 70 70 70 71 70 70 70 70 70 70 70 70 70 70 21 18 10 10 10 10 10 10 10 10 10 10 14 70 70 70 70 15 10 10 11 10 10 10 10 10 10 61 54 37 37 37 40 70 70 70 70
70 70 70 70 70 70 70 70 70 70 70 70 70 70 23 16 10 10 19 13 13 13 13 18 10 10 10 10 10 10 10 10 10 10 10 10 10 10 10 10 10 10 10 10 10 10 14 70 70 70 70 70 70 70 70 71 70 70 70 70 70 70 21 18 10 10 10 10 10 10 10 10 10 10 10 14 70 70 70 70 23 16 10 10 10 10 10 10 10 10 10 61 54 37 43 48 70 70 70 70
70 70 70 70 70 70 70 70 70 70 70 70 70 70 70 15 10 10 10 10 10 10 10 10 10 10 10 10 10 10 10 10 10 10 10 10 10 10 10 10 10 10 10 10 10 10 14 70 70 70 70 70 70 70 70 70 70 70 70 70 70 70 15 10 10 10 10 10 10 11 10 10 10 17 12 22 70 71 70 70 70 23 12 16 10 11 10 10 10 10 10 10 52 37 40 70 70 70 70 70
70 70 70 70 70 70 70 70 70 70 70 70 70 70 70 15 10 10 10 10 10 10 10 10 10 10 10 10 10 10 10 10 10 10 10 10 10 10 10 10 10 10 10 10 10 10 19 62 62 62 62 62 62 62 62 62 62 62 62 62 62 62 18 10 10 10 10 10 10 10 10 10 10 14 70 70 70 71 71 70 70 70 70 15 11 10 10 11 11 10 10 10 61 51 14 70 70 70 70 70
70 70 70 70 70 70 70 70 70 70 70 70 70 21 13 18 10 10 10 10 10 10 10 10 10 10 10 10 10 10 10 10 10 10 10 10 10 10 10 10 10 10 10 10 10 10 10 67 67 67 67 67 67 67 67 67 67 67 67 67 67 67 10 10 10 10 10 11 10 10 10 10 10 14 70 70 71 70 70 70 70 70 70 15 10 10 11 10 10 10 10 10 10 10 19 13 13 20 70 70
70 70 70 70 70 70 70 70 70 21 13 13 13 18 10 10 10 10 10 10 10 10 10 10 10 10 10 10 10 10 10 10 10 10 10 10 10 10 10 10 10 10 10 10 10 10 17 63 63 63 63 63 63 63 63 63 63 63 63 63 63 63 16 10 10 10 11 10 10 10 11 10 10 14 70 70 70 70 70 70 70 70 70 15 10 10 10 11 10 11 10 10 10 10 10 10 10 14 70 70
70 70 70 70 70 70 70 70 21 18 10 10 10 10 10 10 10 10 10 17 12 12 12 16 10 10 10 10 10 10 10 10 10 10 10 10 10 10 10 10 10 10 10 10 10 10 14 70 70 70 70 70 70 70 70 70 70 70 70 70 70 70 15 10 10 10 10 10 10 10 10 10 10 19 20 70 70 70 70 71 70 21 13 18 11 10 10 10 10 10 10 10 10 10 17 12 12 22 70 70
70 70 70 70 70 70 70 70 15 10 10 10 10 10 10 10 10 10 10 14 70 70 70 15 10 10 10 10 10 10 10 10 10 10 10 10 10 10 10 10 10 10 10 10 10 10 14 70 70 70 70 70 70 70 70 70 70 70 70 70 21 13 18 10 10 10 10 10 10 10 10 10 10 10 14 70 71 70 70 70 70 15 10 10 10 10 10 10 10 10 10 10 10 10 14 70 70 70 70 70
70 70 70 70 70 70 70 70 15 10 10 10 10 17 12 12 12 12 12 22 70 70 70 23 16 10 10 10 10 10 10 10 10 10 10 10 10 10 10 10 10 10 10 10 10 10 14 70 70 70 70 70 70 70 70 70 70 70 70 70 15 10 10 10 10 17 12 12 12 12 12 12 12 12 22 70 70 70 70 70 70 23 16 10 10 10 10 10 10 10 10 10 10 10 14 70 70 70 70 70
70 70 70 70 70 70 21 13 18 10 10 10 10 14 70 70 70 70 70 70 70 70 70 70 23 12 16 10 10 10 10 10 10 10 10 10 10 10 10 10 10 10 10 17 12 12 22 70 70 70 70 70 70 70 70 70 70 70 70 70 23 12 16 10 10 14 70 70 70 70 70 70 70 70 70 70 70 70 70 70 70 70 23 12 12 12 12 12 12 12 12 12 12 12 22 70 70 70 70 70
70 70 70 70 70 70 15 10 10 10 10 10 10 14 70 70 70 70 70 70 70 70 70 70 70 70 15 10 10 10 10 10 10 10 10 10 10 10 10 10 10 10 10 14 70 70 70 70 70 70 70 70 70 70 70 70 70 70 70 70 70 70 23 12 12 22 70 70 70 70 70 70 70 70 70 70 70 70 70 70 70 70 70 70 70 70 70 70 70 70 70 70 70 70 70 70 70 70 70 70
70 70 70 70 70 70 23 12 12 12 12 12 12 22 70 70 70 70 70 70 70 70 70 70 70 70 23 12 12 12 12 12 12 12 12 12 16 10 10 10 10 10 17 22 70 70 70 70 70 70 70 70 70 70 70 70 70 70 70 70 70 70 70 70 70 70 70 70 70 70 70 70 70 70 70 70 70 70 70 70 70 70 70 70 70 70 70 70 70 70 70 70 70 70 70 70 70 70 70 70
70 70 70 70 70 70 70 70 70 70 70 70 70 70 70 70 70 70 70 70 70 70 70 70 70 70 70 70 70 70 70 70 70 70 70 70 23 12 12 12 12 12 22 70 70 70 70 70 70 70 70 70 70 70 70 70 70 70 70 70 70 70 70 70 70 70 70 70 70 70 70 70 70 70 70 70 70 70 70 70 70 70 70 70 70 70 70 70 70 70 70 70 70 70 70 70 70 70 70 70
70 70 70 70 70 70 70 70 70 70 70 70 70 70 70 70 70 70 70 70 70 70 70 70 70 70 70 70 70 70 70 70 70 70 70 70 70 70 70 70 70 70 70 70 70 70 70 70 70 70 70 70 70 70 70 70 70 70 70 70 70 70 70 70 70 70 70 70 70 70 70 70 70 70 70 70 70 70 70 70 70 70 70 70 70 70 70 70 70 70 70 70 70 70 70 70 70 70 70 70
70 70 70 70 70 70 70 70 70 70 70 70 70 70 70 70 70 70 70 70 70 70 70 70 70 70 70 70 70 70 70 70 70 70 70 70 70 70 70 70 70 70 70 70 70 70 70 70 70 70 70 70 70 70 70 70 70 70 70 70 70 70 70 70 70 70 70 70 70 70 70 70 70 70 70 70 70 70 70 70 70 70 70 70 70 70 70 70 70 70 70 70 70 70 70 70 70 70 70 70